1111111111111
1000011111001
1111111111111