1111111111111
1C0100000C001
10C0011111001
1P0011E00C001
1111111111111