1111111111111
1C01000000001
10C0011111001
1P0011E00C001
1111111111111